5 11 0 0 4 10
+-+-+-+-+-+-+-+-+-+-+-+
|             |       |
+-+-+-+-+-+ +-+ +-+-+ +
|                     |
+-+-+-+-+-+-+-+-+-+ +-+
|                     |
+-+ +-+-+-+-+-+-+-+-+-+
|                     |
+-+-+ +-+-+-+-+-+-+-+-+
|                     |
+-+-+-+-+-+-+-+-+-+-+-+
