3 6 0 0 2 3
+-+-+-+-+-+-+
|     |     |
+ +-+-+ +-+ +
|           |
+-+-+-+-+-+-+
|           |
+-+-+-+-+-+-+

